L_AError = Errore Interno.
L_ALegal = Legale!
L_AnalysisUnavailable = Anilisi non disponibile per questo Pokémon.
L_AValid = Valido.
L_F0_1 = {0}: {1}
L_F0_M_1_2 = {0} Mossa {1}: {2}
L_F0_RM_1_2 = {0} Mossa Ricordabile {1}: {2}
L_FEncounterType_0 = Tipo Incontro: {0}
L_FOriginSeed_0 = Seed di origine: {0}
L_FPIDType_0 = Tipo PID: {0}
L_SFishy = Sospetto
L_SInvalid = Invalido
L_SNotImplemented = Non implementato
L_SValid = Valido
L_XEnigmaBerry_0 = BACCA{0}
L_XHT = HT
L_XKorean = Korean
L_XKoreanNon = Non-Korean
L_XLocation = Location
L_XMatches0_1 = Matches: {0} {1}
L_XNickname = Nickname
L_XOT = OT
L_XRareFormEvo_0_1 = Evolve nella forma: {0} (rara: {1})
L_XWurmpleEvo_0 = Evoluzione Wurmple: {0}
LAbilityCapsuleUsed = Abilità disponibile con la Capsula Abilità.
LAbilityFlag = Abilità corrispondente al Numero Abilità.
LAbilityHiddenFail = Abilità Nascosta non corrispondente al Tipo di Incontro.
LAbilityHiddenUnavailable = Abilità Nascosta non disponibile.
LAbilityMismatch = Abilità non corrispondente al Tipo di Incontro.
LAbilityMismatch3 = L'Abilità non corrisponde a quelle disponibili per la Gen 3.
LAbilityMismatchFlag = Abilità non corrispondente al Numero Abilità.
LAbilityMismatchGift = L'Abilità non corrisponde al Dono Segreto.
LAbilityMismatchGrotto = Le catture del Meandro Nascosto dovrebbero avere l'Abilità Nascosta.
LAbilityMismatchHordeSafari = Abilità Nascosta su un Pokémon non proveniente dal Safari o da un Gruppo.
LAbilityMismatchPID = l'Abilità non corrisponde al PID.
LAbilityMismatchSOS = Abilità Nascosta su un Pokémon non proveniente da una chiamata di aiuto.
LAbilityPatchRevertUsed = Ability available with Ability Patch Revert.
LAbilityPatchUsed = Abilità disponibile con il Cerotto Abilità.
LAbilityUnexpected = Abilità non valida per la Specie/Forma.
LAwakenedCap = AV individuali non possono essere superiori a {0}.
LAwakenedShouldBeValue = AV individuali ({1}) dovrebbero essere {0}.
LBallAbility = Impossibile ottenere l'Abilità con la Ball.
LBallEggCherish = Le uova non possono essere in Pregio Ball.
LBallEggMaster = Le uova non possono essere in Master Ball.
LBallEnc = Ball corretta per il tipo di incontro.
LBallEncMismatch = Questo tipo di incontro non può avere questa Ball.
LBallHeavy = Impossibile avere la Peso Ball per Pokémon leggeri con catch rate basso (gen VII).
LBallNone = Nessun controllo sodisfatto, si assume sia illegale.
LBallSpecies = Impossibile ottenere questa specie in questa Ball.
LBallSpeciesPass = Ball possibile per la specie.
LBallUnavailable = Ball inottenibile nella generazione di origine.
LContestSheenTooHigh_0 = Il Lustro dovrebbe essere <= {0}.
LContestSheenTooLow_0 = Il Lustro dovrebbe essere >= {0}.
LContestZero = Le statistiche delle Gare dovrebbero essere 0.
LContestZeroSheen = Il Lustro dovrebbe essere 0.
LDateOutsideDistributionWindow = La data di incontro è al di fuori del periodo di Distribuzione.
LEffort2Remaining = 2 EV rimanenti.
LEffortAbove252 = Gli EV non possono essere maggiori di 252.
LEffortAbove510 = Gli EV totali non possono essere maggiori di 510.
LEffortAllEqual = Gli EV sono tutti uguali.
LEffortCap100 = EV individuali per incontri di livello 100 in Gen 4 non possono essere maggiori di 100.
LEffortEgg = Le Uova non possono ricevere EV.
LEffortEXPIncreased = Gli EV sono Zero, ma il Pokémon è di livello superiore a quello di incontro.
LEffortShouldBeZero = Non può ricevere EV.
LEffortUntrainedCap = EV individuali senza guadagnare EXP non possono essere maggiori di {0}.
LEggContest = Le statistiche delle gare non possono crescere per un Uovo.
LEggEXP = Le Uova non possono ricevere esperienza.
LEggFMetLevel_0 = Livello di incontro invalido, valore previsto {0}.
LEggHatchCycles = Cicli di schiusa dell'Uovo invalidi.
LEggLocation = È possibile schiudere un Uovo nel luogo di incontro.
LEggLocationInvalid = Impossibile schiudere un Uovo nel luogo di incontro.
LEggLocationNone = Luogo dell'Uovo invalido, valore previsto None.
LEggLocationPalPark = Luogo di incontro invalido, valore previsto Parco Amici.
LEggLocationTrade = È possibile schiudere un Uovo scambiato nel luogo di incontro.
LEggLocationTradeFail = Il luogo di incontro non dovrebbe essere 'Scambio', se è un Uovo.
LEggMetLocationFail = Impossibile ottenre l'Uovo nel Luogo dell'Uovo.
LEggNature = Le Uova non possono avere la Natura delle Statistiche cambiata.
LEggPokeathlon = Le Uova non possono avere statistiche Pokéathlon.
LEggPokerus = Le Uova non possono essere infette da Pokérus.
LEggPP = Le Uova non possono avere modifiche ai PP.
LEggPPUp = Non si possono applicare PP Up alle Uova.
LEggRelearnFlags = Non sono previsti segnali di Mosse Ricordabili.
LEggShinyLeaf = Le Uova non possono avere Foglielucenti o la Corona di Foglie.
LEggShinyPokeStar = Le Uova non possono essere Star del Pokéwood.
LEggSpecies = Impossibile ottenere Uova di questa specie.
LEggUnhatched = Uovo non schiuso valido.
LEncCondition = Incontro selvatico valido nel luogo.
LEncConditionBadRNGFrame = Impossibile trovare una corrispondenza delle condizioni di incontro ad un possibile Frame RNG.
LEncConditionBadSpecies = La specie non esiste nel gioco di origine.
LEncConditionBlack = Incontro selvatico valido nel Luogo (Flauto Nero).
LEncConditionBlackLead = Incontro selvatico valido nel Luogo (Flauto Nero & Pressione/Tuttafretta/Spritovivo).
LEncConditionDexNav = Incontro selvatico valido nel Luogo (Navidex).
LEncConditionLead = Incontro selvatico valido nel Luogo (Pressione/Tuttafretta/Spiritovivo).
LEncConditionWhite = Incontro selvatico valido nel Luogo (Flauto Bianco).
LEncConditionWhiteLead = Incontro selvatico valido nel Luogo (Flauto Bianco & Pressione/Tuttafretta/Spiritovivo).
LEncGift = Impossibile trovare una corrispondenza per un Uovo donato dal gioco di origine.
LEncGiftEggEvent = Impossibile trovare una corrispondenza per un Uovo evento dal gioco di origine.
LEncGiftIVMismatch = Gli IV non corrispondono al Dono Segreto.
LEncGiftNicknamed = il Dono Segreto è stato soprannominato.
LEncGiftNotFound = Impossibile trovare una corrispondenza ai Doni Segreti nel Database.
LEncGiftPIDMismatch = Il PID non corrisponde a quello del Dono Segreto.
LEncGiftShinyMismatch = Il Dono Segreto non può essere Shiny.
LEncGiftVersionNotDistributed = Il Dono Segreto non può essere ricevuto in questa versione di gioco.
LEncInvalid = Impossibile trovare una corrispondenza per l'incontro nel gioco di origine.
LEncMasteryInitial = Initial move mastery flags do not match the encounter's expected state.
LEncStaticMatch = Dono/Incontro statico valido.
LEncStaticPIDShiny = L'Incontro statico non può essere shiny.
LEncStaticRelearn = L'incontro statico non può avere la mossa ricordabile.
LEncTradeChangedNickname = Il soprannome del Pokémon ottenuto con uno scambio in gioco è stato alterato.
LEncTradeChangedOT = Il Nome dell'AO di un Pokémon ottenuto con uno scambio in gioco è stato alterato.
LEncTradeIndexBad = Indice di scambio in gioco invalido?
LEncTradeMatch = Scambio in gioco valido.
LEncTradeUnchanged = Il nome dell'AO e il soprannome del Pokémon ottenuto con uno scambio in gioco sono validi.
LEncTypeMatch = Il tipo di incontro corrisponde all'incontro.
LEncTypeMismatch = il tipo di incontro non corrisponde all'incontro.
LEncUnreleased = Evento non rilasciato ufficialmente.
LEncUnreleasedEMewJP = L'evento di Mew è stato rilasciato solo in Giappone.
LEncUnreleasedHoOArceus = Arceus dallo Spazio Origine. L'Evento non è mai stato rilasciato.
LEncUnreleasedPtDarkrai = Darkrai dall'Isola Lunanuova non proveniente da Platino. L'Evento non è mai stato rilasciato.
LEncUnreleasedPtShaymin = Shaymin dal Paradiso Fiore non proveniente da Platino. L'Evento non è mai stato rilasciato.
LEReaderAmerica = Bacca da E-Reader Americano in un salvataggio Giapponese.
LEReaderInvalid = Bacca E-Reader invalida.
LEReaderJapan = Bacca da E-Reader Giapponese in un salvataggio Internazionale.
LEvoInvalid = Evoluzione non valida (o i requisiti di livello/scambio non sono soddisfatti).
LEvoTradeReq = Lo scambio in gioco {0} si sarebbe dovuto evolvere in {1}.
LEvoTradeReqOutsider = L'outsider {0} si sarebbe dovuto evolvere in {1}.
LEvoTradeRequired = L'evoluzione è specifica di una versione di gioco e richiede uno scambio. Il Pokémon deve avere un Ultimo Allenatore.
LFateful = Incontro mediante Evento Speciale in gioco.
LFatefulGiftMissing = Evento Speciale senza corrispondenze. I dati per il Dono Segreto sono stati contribuiti?
LFatefulInvalid = Evento Speciale non dovrebbe essere selezionato.
LFatefulMissing = Il segnale di Evento Speciale in gioco non è presente.
LFatefulMystery = Evento Speciale da Dono Segreto.
LFatefulMysteryMissing = Il segnale di Evento Speciale deve essere presente per il Dono Segreto.
LFavoriteMarkingUnavailable = Segnalino preferito non disponibile.
LFormArgumentHigh = L'Argomento di forma è troppo grande per la forma attuale.
LFormArgumentInvalid = L'Argomento di forma non è valido.
LFormArgumentLow = L'Argomento di forma è troppo basso per la forma attuale.
LFormArgumentNotAllowed = L'Argomento di forma non è disponibile per questo incontro.
LFormArgumentValid = L'Argomento di Forma è valido.
LFormBattle = La Forma non può esistere al di fuori di una battaglia.
LFormEternal = Incontro per Fiore Eterno valido.
LFormEternalInvalid = Incontro per Fiore Eterno non valido.
LFormInvalidExpect_0 = La forma è invalida, valore atteso: {0}.
LFormInvalidGame = La forma non può essere ottenuta nel gioco di origine.
LFormInvalidNature = La forma non può avere la natura.
LFormInvalidRange = Il conteggio della forma è fuori dall'indice. Valore previsto <= {0}, non {1}.
LFormItem = Lo strumento tenuto corrisponde alla forma.
LFormItemInvalid = Lo strumento tenuto non corrisponde alla forma.
LFormParty = La forma non può esistere al di fuori della squadra.
LFormPikachuCosplay = Solo Cosplay Pikachu può avere questa forma.
LFormPikachuCosplayInvalid = Cosplay Pikachu non può avere la forma base.
LFormPikachuEventInvalid = Pikachu Evento non può avere la forma base.
LFormValid = La forma è valida.
LFormVivillon = Il pattern di Vivillion è valido.
LFormVivillonEventPre = Il pattern di Vivillion evento è in una pre-evoluzione.
LFormVivillonInvalid = Il pattern di Vivillion non è valido.
LFormVivillonNonNative = Il pattern di Vivillion non è nativo.
LG1CatchRateChain = Il tasso di cattura non corrisponde a nessuna specie della catena evolutiva.
LG1CatchRateEvo = Il tasso di cattura corrisponde la specie senza incontri. Previsto il tasso di cattura di una pre-evoluzione.
LG1CatchRateItem = Il tasso di cattura non corrisponde ad un valido strumento tenuto nella seconda generazione.
LG1CatchRateMatchPrevious = Il tasso di cattura corrisponde tutte le specie della catena evolutiva.
LG1CatchRateMatchTradeback = Il tasso di cattura corrisponde ad un valido strumento tenuto nella seconda generazione.
LG1CatchRateNone = Il tasso di cattura non corrisponde a nessuna specie della catena evolutiva o ad alcun valido strumento tenuto nella seconda generazione.
LG1CharNick = Il soprannome da Gen1/2 utilizza caratteri proibiti.
LG1CharOT = Il nome allenatore da Gen1/2 utilizza caratteri proibiti.
LG1GBEncounter = Impossibile ottenere Incontri Speciali nei giochi Virtual Console.
LG1MoveExclusive = Mossa esclusiva della prima generazione. Incompatibile con le mosse non-tradeback.
LG1MoveLearnSameLevel = Mosse incompatibili. Imparate allo stesso livello in Rosso/Blu e Giallo.
LG1MoveTradeback = Mossa uovo non-tradeback. Incompatibile con le mosse esclusive da Gen1.
LG1OTEvent = Nome AO da evento RBG non corretto.
LG1OTGender = AO Femmina da Gen1/2 è invalido.
LG1Stadium = L'AO di Stadium è invalido.
LG1StadiumInternational = L'AO da Stadium Internazionale è valido.
LG1StadiumJapanese = L'AO da Stadium Giapponese è valido.
LG1TradebackPreEvoMove = Mossa pre-evolutiva non-tradeback. Incompatibile con le mosse esclusive di Gen1.
LG1Type1Fail = Tipo A invalido, non corrisponde al tipo specie.
LG1Type2Fail = Tipo B invalido, non corrisponde al tipo specie.
LG1TypeMatch1 = Tipo A valido, corrisponde al tipo specie.
LG1TypeMatch2 = Tipo B valido, corrisponde al tipo specie.
LG1TypeMatchPorygon = Porygon con tipo A e B valido.
LG1TypePorygonFail = Porygon con tipo A e B invalido. Non corrisponde a nessuna possibile combinazione.
LG1TypePorygonFail1 = Porygon con tipo A invalido.
LG1TypePorygonFail2 = Porygon con tipo B invalido.
LG2InvalidTilePark = Incontro da pesca al Parco Nazionale. La casella d'acqua non è raggiungibile.
LG2InvalidTileR14 = Incontro da pesca nel Percorso 14 di Kanto. La casella d'acqua non è raggiungibile.
LG2InvalidTileSafari = Incontro da pesca nella Zona Safari in Gen2. Zona irraggiungibile.
LG2InvalidTileTreeID = Trovato un albero irraggiungibile per un incontro Bottintesta su Cristallo che corrisponde al OTID.
LG2InvalidTileTreeNotFound = Impossibile trovare un incontro Bottintesta su Cristallo che corrisponda al OTID.
LG2OTGender = AO di giochi Virtual Console ad eccezione di Cristallo non possono essere femmina.
LG2TreeID = Trovato un albero per un incontro Bottintesta su Cristallo che corrisponde al OTID.
LG3EReader = Incontro Ombra E-Reader non Giapponese. Evento non rilasciato.
LG3OTGender = AO di Colosseum/XD non possono essere femmina.
LG4InvalidTileR45Surf = Incontro da surf nel Percorso 45 di Johto, la casella d'acqua è irraggiungibile.
LG5ID_N = Il Nome/TID16/SID16 di N non è corretto.
LG5IVAll30 = Tutti gli IV dei Pokémon di N dovrebbero essere 30.
LG5OTGenderN = I Pokémon di N devono avere il sesso dell'AO maschio.
LG5PIDShinyGrotto = Gli incontri del Meandro Nascosto non possono essere Shiny.
LG5PIDShinyN = I Pokémon di N non possono essere Shiny.
LG5SparkleInvalid = Il segnale speciale di luccichio dei Pokémon di N non dovrebbe essere ablitato.
LG5SparkleRequired = Segnale speciale di luccichio dei Pokémon di N assente.
LGanbaruStatTooHigh = Uno o più valori Ganbaru è oltre il limite naturale di (10 - IV bonus).
LGenderInvalidNone = I Pokémon senza sesso non dovrebbero avere un Sesso.
LGeoBadOrder = Memoria GeoLocation: Gap/Blank.
LGeoHardwareInvalid = Geolocation: La nazione non è disponibile nel 3DS.
LGeoHardwareRange = Regione della console non valida.
LGeoHardwareValid = Geolocation: la nazione è disponibile nel 3DS.
LGeoMemoryMissing = Memoria GeoLocation: le memorie dovrebbero essere presenti.
LGeoNoCountryHT = Memoria GeoLocation: è presente un nome per l'Ultimo Allenatore, ma non ha una nazione.
LGeoNoRegion = Memoria GeoLocation: la regione è senza nazione.
LHyperPerfectAll = Impossibile usare l'Allenamento Pro su un Pokémon con IV perfetti.
LHyperPerfectOne = Impossibile usare l'Allenamento Pro un IV perfetto.
LHyperPerfectUnavailable = L'Allenamento Pro non è possibile su alcun IV.
LHyperTooLow_0 = Impossibile usare l'Allenamento Pro su un Pokémon che non sia al livello {0}.
LItemEgg = Le Uova non possono tenere strumenti.
LItemUnreleased = Lo strumento tenuto non è stato rilasciato.
LIVAllEqual_0 = Tutti gli IV sono {0}.
LIVF_COUNT0_31 = Dovrebbe avere almeno {0} IVs = 31.
LIVNotCorrect = Gli IV non combaciano con i requisiti dell'incontro.
LLevelEXPThreshold = L'Esperienza è compatibile con il treshold del livello.
LLevelEXPTooHigh = Current experience exceeds maximum amount for level 100.
LLevelMetBelow = Il livello attuale è al di sotto del livello di incontro.
LLevelMetGift = Il livello di incontro non corrisponde al Dono Segreto.
LLevelMetGiftFail = Il livello attuale è al di sotto del livello del Dono Segreto.
LLevelMetSane = Il livello attuale non è al di sotto del livello di incontro.
LMarkValueOutOfRange_0 = Individual marking at index {0} is not within the allowed value range.
LMarkValueShouldBeZero = Marking flags cannot be set.
LMarkValueUnusedBitsPresent = Marking flags uses bits beyond the accessible range.
LMemoryArgBadCatch = Memoria {0}: {0} non lo ha catturato.
LMemoryArgBadHatch = Memoria {0}: {0} non lo ha schiuso.
LMemoryArgBadHT = Memoria: Non può avere memorie di un Ultimo Allenatore da Uovo.
LMemoryArgBadID = Memoria {0}: Impossibile ottenere la Memoria nella versione {0}.
LMemoryArgBadItem = Memoria {0}: La specie non può tenere questo oggetto.
LMemoryArgBadLocation = Memoria {0}: Impossibile avere il Luogo nella versione {0}.
LMemoryArgBadMove = Memoria {0}: La specie non può imparare questa mossa.
LMemoryArgBadOTEgg = Memoria {0}: Scambio in Link non è valida come prima memoria.
LMemoryArgBadSpecies = Memoria {0}: Impossibile catturare questa specie nel gioco.
LMemoryArgSpecies = Memoria {0}: La specie può essere catturata nel gioco.
LMemoryCleared = Memoria: Non ripulita correttamente.
LMemoryF_0_Valid = Memoria {0} valida.
LMemoryFeelInvalid = Memoria {0}: Sentimenti invalidi.
LMemoryHTFlagInvalid = Untraded: L'Allenatore Attuale non dovrebbe essere l'Ultimo Allenatore (non AO).
LMemoryHTGender = Genere dell'Ultimo Allenatore invalido: {0}
LMemoryHTLanguage = Lingua dell'Ultimo Allenatore mancante.
LMemoryIndexArgHT = Dovrebbe avere una memoria per l'Ultimo Allenatore TextVar.
LMemoryIndexFeel = Memoria {0}: il Sentimento dovrebbe essere di indice {1}.
LMemoryIndexFeelHT09 = Dovrebbe avere un feeling per l'Ultimo Allenatore di 0-9.
LMemoryIndexID = Memoria {0}: Dovrebbe essere di indice {1}.
LMemoryIndexIntensity = Memoria {0}: L'Intensità dovrebbe essere di indice {1}.
LMemoryIndexIntensityHT1 = Dovrebbe avere un valore di intensità per l'Ultimo Allenatore (primo).
LMemoryIndexIntensityMin = Memoria {0}: l'Intensità dovrebbe essere di almeno {1}.
LMemoryIndexLinkHT = Dovrebbe avere memoria di un Ultimo Allenatore per Scambio in Link.
LMemoryIndexVar = Memoria {0}: TextVar dovrebbe essere di indice {1}.
LMemoryMissingHT = Memoria: Le memorie per l'Ultimo Allenatore sono assenti.
LMemoryMissingOT = Memoria: memoria per l'Allenatore Originale mancante.
LMemorySocialTooHigh_0 = Social Stat dovrebbe essere <= {0}
LMemorySocialZero = Social Stat dovrebbe essere zero.
LMemoryStatAffectionHT0 = Untraded: l'Affetto per l'Ultimo Allenatore dovrebbe essere 0.
LMemoryStatAffectionOT0 = l'Affetto per l'AO dovrebbe essere 0.
LMemoryStatEnjoyment = Enjoyment dovrebbe essere {0}.
LMemoryStatFriendshipHT0 = Untraded: l'Amicizia per l'Ultimo Allenatore dovrebbe essere 0.
LMemoryStatFriendshipOTBaseEvent = L'Amicizia all'AO evento non corrisponde con l'amicizia base.
LMemoryStatFullness = Fullness dovrebbe essere {0}.
LMetDetailTimeOfDay = L'Ora di incontro non è all'interno della gamma attesa.
LMoveEggFIncompatible0_1 = {0} Mossa Ereditata. Incompatibile con {1} mossa ereditata.
LMoveEggIncompatible = Mossa uovo. Incompatibile con mosse uovo evento.
LMoveEggIncompatibleEvent = Mossa uovo evento. Incompatibile con mosse uovo normali.
LMoveEggInherited = Mossa uovo ereditata.
LMoveEggInheritedTutor = Mossa tutor ereditata.
LMoveEggInvalid = Non è una mossa uovo prevista.
LMoveEggInvalidEvent = Mossa uovo. Non prevista in un uovo evento.
LMoveEggInvalidEventLevelUp = Mossa ereditata acquisita con aumento di livello. Non prevista in un uovo evento.
LMoveEggInvalidEventLevelUpGift = Mossa ereditata acquisita con aumento di livelllo. Non prevista in un uovo donato.
LMoveEggInvalidEventTMHM = Mossa MT/MN ereditata. Non prevista in un uovo evento.
LMoveEggInvalidEventTutor = Mossa totor ereditata. Non prevista in un uovo evento.
LMoveEggLevelUp = Mossa ereditata acquisita tramite aumento di livello.
LMoveEggMissing = Mossa uovo evento mancante.
LMoveEggMoveGift = Mossa uovo. Non prevista in un uovo donato.
LMoveEggTMHM = Mossa MT/MN ereditata.
LMoveEventEggLevelUp = Mossa ereditata acquisita tramite aumento di livello. Incompatibile con mosse uovo evento.
LMoveEvoFCombination_0 = la combinazione di mosse non è compatibile con l'evoluzione di {0}.
LMoveEvoFHigher = Mosse evolutive incompatibili. {1} mossa imparata ad un livello pù alto delle altre {0} mosse.
LMoveEvoFLower = Mosse evolutive non compatibili. {0} mossa imparata ad un livello più basso delle altre {1} mosse.
LMoveFDefault_0 = Mossa base in generazione {0}.
LMoveFExpect_0 = Previste le seguenti mosse: {0}
LMoveFExpectSingle_0 = Expected: {0}
LMoveFLevelUp_0 = Acquisita per aumento di livello in gen {0}.
LMoveFTMHM_0 = Acquisita tramite MT/MN in gen {0}.
LMoveFTutor_0 = Insegnata da un Tutor Mosse in gen {0}.
LMoveKeldeoMismatch = Mossa/Forma di Keldeo non corrispondente.
LMoveNincada = Solo una mossa di Ninjask è concessa.
LMoveNincadaEvo = Acquisita evolvendo Nincada in Ninjask.
LMoveNincadaEvoF_0 = Acquisita evolvendo Nincada in Ninjask in gen {0}.
LMovePPTooHigh_0 = I PP della mossa {0} sono oltre il massimo consentito.
LMovePPUpsTooHigh_0 = I PP Up della mossa {0} sono oltre il massimo consentito.
LMoveRelearnDexNav = Non è una mossa da Navidex prevista.
LMoveRelearnEgg = Mossa uovo base.
LMoveRelearnEggMissing = Mossa uovo base mancante.
LMoveRelearnFExpect_0 = Previste le seguenti mosse ricordabili: {0} ({1})
LMoveRelearnFMiss_0 = Mosse ricordabili mancanti: {0}
LMoveRelearnInvalid = Non è una mossa ricordabile prevista.
LMoveRelearnNone = Non è prevista una mossa ricordabile nello slot.
LMoveRelearnUnderground = Non è una mossa uovo sotterranea prevista.
LMoveShopAlphaMoveShouldBeMastered = La Mossa Alfa dovrebbe essere registrata come masterata.
LMoveShopAlphaMoveShouldBeOther = L'incontro Alfa non può essere trovato con questa mossa Alfa.
LMoveShopAlphaMoveShouldBeZero = Solo gli Alfa possono avere una mossa Alfa.
LMoveShopMasterInvalid_0 = Impossibile masterare manualmente {0}: non è permesso masterare.
LMoveShopMasterNotLearned_0 = Impossibile masterare manualmente {0}: non in possibili mosse acquisite per aumento di livello.
LMoveShopPurchaseInvalid_0 = Impossibile acquistare {0} dal negozio mosse.
LMoveSourceDefault = Mossa base.
LMoveSourceDuplicate = Mossa duplicata.
LMoveSourceEgg = Mossa uovo.
LMoveSourceEggEvent = Mossa uovo evento.
LMoveSourceEmpty = Mossa vuota.
LMoveSourceInvalid = Mossa invalida.
LMoveSourceInvalidSketch = Mossa invalida (Schizzo).
LMoveSourceLevelUp = Acquisita per aumento di livello.
LMoveSourceRelearn = Mossa ricordabile.
LMoveSourceShared = Shared Non-Relearn Move.
LMoveSourceSharedF = Shared Non-Relearn Move in Generation {0}.
LMoveSourceSpecial = Special Non-Relearn Move.
LMoveSourceTMHM = Acquisita tramite MT/MN.
LMoveSourceTR = Record per Disco Tecnico non aspettato: {0}
LMoveSourceTutor = Insegnata dal Tutor Mosse.
LNickFlagEggNo = L'Uovo non deve avere soprannomi.
LNickFlagEggYes = L'Egg deve avere il soprannome.
LNickInvalidChar = Non può avere questo soprannome.
LNickLengthLong = Soprannome troppo lungo.
LNickLengthShort = Il soprannome è vuoto.
LNickMatchLanguage = Il soprannome è uguale alla specie.
LNickMatchLanguageEgg = L'Uovo corrisponde al nome in lingua dell'Uovo.
LNickMatchLanguageEggFail = L'uovo non corrisponde al nome in lingua dell'Uovo.
LNickMatchLanguageFail = Il soprannome non corrisponde alla specie.
LNickMatchLanguageFlag = Soprannome segnalato, corrisponde al nome della specie.
LNickMatchNoOthers = Il soprannome non corrisponde al nome di un altra specie.
LNickMatchNoOthersFail = Il soprannome corrisponde al nome di un'altra specie (+language).
LOT_IDEqual = TID16 e SID16 sono uguali.
LOT_IDInvalid = la combinazione di TID e SID non è possibile.
LOT_IDs0 = TID16 e SID16 sono 0.
LOT_SID0 = SID16 è zero.
LOT_SID0Invalid = SID16 dovrebbe essere 0.
LOT_TID0 = TID16 è zero.
LOTLanguage = Language ID dovrebbe essere {0}, non {1}.
LOTLong = Nome AO troppo lungo.
LOTShort = Nome AO troppo corto.
LOTSuspicious = Dettagli dell'AO sospetti.
LPIDEncryptWurmple = Wurmple evolution Encryption Constant mismatch.
LPIDEncryptZero = Encryption Constant non impostata.
LPIDEqualsEC = Encryption Constant uguale al PID.
LPIDGenderMatch = Il sesso combacia con il PID.
LPIDGenderMismatch = Il sesso non combacia con il PID.
LPIDNatureMatch = La Natura combacia il PID.
LPIDNatureMismatch = La Natura non combacia con il PID.
LPIDTypeMismatch = PID+ correlation does not match what was expected for the Encounter's type.
LPIDZero = Il PID non è impostato.
LPokerusDaysTooHigh_0 = I giorni di Pokérus rimanenti sono troppi, previsto <= {0}.
LPokerusStrainUnobtainable_0 = Pokérus Strain {0} non può essere ottenuta.
LRibbonAllValid = Tutti i fiocchi sono stati contabilizzati.
LRibbonEgg = Non può avere fiocchi da Uovo.
LRibbonFInvalid_0 = Fiocchi invalidi: 
LRibbonFMissing_0 = Fiocchi mancanti: 
LRibbonMarkingAffixedF_0 = Fioccho o Emblema fissato invalido: {0}
LRibbonMarkingFInvalid_0 = Emblema invalido: {0}
LStatAlphaInvalid = Alfa non corrispondente.
LStatBattleVersionInvalid = la Versione Lotta non è in un range accettabile.
LStatDynamaxInvalid = Il Livello Dynamax non è in un range accettabile.
LStatGigantamaxInvalid = Gigamax non corrispondente.
LStatGigantamaxValid = Gigamax ottenuto con la Zuppamax.
LStatIncorrectCP = I PL calcolati non combaciano con il valore nei dati.
LStatIncorrectHeight = L'Altezza calcolata non corrisponde con il valore nei dati.
LStatIncorrectHeightCopy = Copy Height non corrisponde il valore originale.
LStatIncorrectHeightValue = L'Altezza non combacia con il valore previsto.
LStatIncorrectWeight = Il Peso calcolato non corrisponde con il valore nei dati.
LStatIncorrectWeightValue = Il Peso non cirrsponde con il valore previsto.
LStatInvalidHeightWeight = Il valore di Altezza e Peso è statisticamente improbabile.
LStatNatureInvalid = La Natura delle Statistiche non è in un range accettabile.
LStatNobleInvalid = Sgnale Nobile non corrispondente.
LSuperComplete = Segnale di completamento del Super Allenamento non corrispondente.
LSuperDistro = Le missioni evento per il Super Allenamento non sono state rilasciate.
LSuperEgg = Un Uovo non può partecipare al Super Allenamento.
LSuperNoComplete = Non può aver completato il Super Allenamento per l'origine.
LSuperNoUnlocked = Non può avere il segnale di Sblocco Super Allenamento per l'origine.
LSuperUnavailable = Le missioni di Super Allenamento non sono disponibili nei giochi visitati.
LSuperUnused = Il segnale inutilizzato per il Super Allenamento è stato abilitato.
LTeraTypeIncorrect = Il Tera Tipo non corrisponde al valore atteso.
LTeraTypeMismatch = Il Tera Tipo non corrisponde a nessuno dei due tipi base.
LTradeNotAvailable = Il Pokémon non può essere scambiato all'Allenatore attuale.
LTransferBad = Il Pokémon trasferito da una generazione passata non è stato trasferito correttamente, o non è compatibile con questo salvataggio.
LTransferCurrentHandlerInvalid = Il valore dell'Ultimo Allenatore è invalido, i dettagli allenatori del salvataggio non sono corretti.
LTransferEgg = Impossibile tarsferire Uova tra Generazioni diverse.
LTransferEggLocationTransporter = Luogo di incontro non valido, previsto Pokétrasporto.
LTransferEggMetLevel = Livello di incontro non valido per il trasferimento.
LTransferFlagIllegal = Segnato come Illegale dal gioco (abuso di glitch o clonazione).
LTransferHTFlagRequired = Current handler cannot be past gen OT for transferred specimen (l'Allenatore Originale non può essere l'Ultimo Allenatore).
LTransferHTMismatchGender = Handling trainer does not match the expected trainer gender.
LTransferHTMismatchLanguage = La lingua dell'Ultimo Allenatore non corrisponde al valore atteso.
LTransferHTMismatchName = Il nome dell'Ultimo Allenatore non corrisponde al valore atteso.
LTransferMet = Luogo di incontro invalido, previsto Pokétrasporto o Corona.
LTransferMetLocation = Luogo di trasferimento non valido.
LTransferMove = Mossa di trasferimento non valida.
LTransferMoveG4HM = Scacciabruma e Mulinello. Una delle due mosse deve essere rimossa prima di poter avviare il trasferimento verso Gen 5.
LTransferMoveHM = MN di {0} Gen. Deve essere rimossa prima di poter avviare il trasferimento verso Gen {1}.
LTransferNature = Natura non valida per il processo di trasferimento.
LTransferNotPossible = Impossibile trasferire il Pokémon dal formato originale al formato attuale.
LTransferObedienceLevel = Livello di Obbedienza invalido.
LTransferOriginFInvalid0_1 = L'origine {0} non può esistere nell'attuale ({1}) file di salvataggio.
LTransferPIDECBitFlip = Il PID dovrebbe essere uguale alla EC [con i bit superiori flippati]!
LTransferPIDECEquals = Il PID dovrebbe essere uguale alla EC!
LTransferPIDECXor = La Encryption Constant corrisponde ad un PID shiny.
LTransferTrackerMissing = Il codice di monitoraggio di Pokémon Home è mancante.
LTransferTrackerShouldBeZero = Il codice di monitoraggio di Pokémon Home dovrebbe essere 0.
LTrashBytesExpected = Expected Trash Bytes.
LTrashBytesExpected_0 = Expected Trash Bytes: {0}
LTrashBytesMismatchInitial = Expected initial trash bytes to match the encounter.
LTrashBytesMissingTerminator = Final terminator missing.
LTrashBytesShouldBeEmpty = Trash Bytes should be cleared.
LTrashBytesUnexpected = Unexpected Trash Bytes.
