L_AError = 内部エラー
L_ALegal = 正規
L_AnalysisUnavailable = このポケモンは分析できません
L_AValid = 有効
L_F0_1 = {0}: {1}
L_F0_M_1_2 = {0} 技 {1}: {2}
L_F0_RM_1_2 = {0} 思い出し技 {1}: {2}
L_FEncounterType_0 = エンカウンタータイプ: {0}
L_FOriginSeed_0 = 元のシード: {0}
L_FPIDType_0 = 性格値: {0}
L_SFishy = 怪しい
L_SInvalid = エラー
L_SNotImplemented = 実装されていません
L_SValid = 有効
L_XEnigmaBerry_0 = {0}のみ
L_XHT = 現在のトレーナー
L_XKorean = 韓国
L_XKoreanNon = 韓国以外
L_XLocation = Location
L_XMatches0_1 = 一致: {0} {1}
L_XNickname = Nickname
L_XOT = 元々のトレーナー
L_XRareFormEvo_0_1 = 次のフォルムに進化: {0} (レア: {1})
L_XWurmpleEvo_0 = ケムッソの進化: {0}
LAbilityCapsuleUsed = とくせいカプセルを使うことで使用可能な特性です。
LAbilityFlag = 特性が特性番号と一致。
LAbilityHiddenFail = エンカウントタイプに対して、特性が隠れ特性ではありません。
LAbilityHiddenUnavailable = 隠れ特性にはできません。
LAbilityMismatch = 特性がエンカウントタイプと一致しません。
LAbilityMismatch3 = 第３世代のポケモンの特性と一致しません。
LAbilityMismatchFlag = 特性の番号が一致しません。
LAbilityMismatchGift = 特性がふしぎなおくりものデータベースと一致しません。
LAbilityMismatchGrotto = 隠し穴で捕まえたポケモンは、必ず隠れ特性でなければなりません。
LAbilityMismatchHordeSafari = 群れバトル/フレンドサファリ産ではない隠れ特性です。
LAbilityMismatchPID = 特性と性格値が一致しません。性格値を再生成してください。
LAbilityMismatchSOS = 乱入バトル産ではない隠れ特性です。
LAbilityPatchRevertUsed = とくせいパッチで元に戻すことで使用可能な特性です。
LAbilityPatchUsed = とくせいパッチを使うことで使用可能な特性です。
LAbilityUnexpected = その種族/フォルムでは、この特性は無効です。
LAwakenedCap = 各覚醒値は {0} を超えることはできません。
LAwakenedShouldBeValue = 各覚醒値 ({1}) は {0} を超えることはできません。
LBallAbility = そのボールでは隠れ特性の個体を捕獲できません。
LBallEggCherish = プレシャルボールは遺伝できません。
LBallEggMaster = マスターボールは遺伝できません。
LBallEnc = エンカウントタイプに合った正規のボールです。
LBallEncMismatch = このボールでは捕獲できません。
LBallHeavy = ヘビーボールのバグにより、捕獲は不可能です。（SMのみ）
LBallNone = 改造個体の可能性があります。
LBallSpecies = このボールでは捕獲できません。
LBallSpeciesPass = ポケモンによっては捕獲可能なボール。
LBallUnavailable = 元の世代では入手できないボール。
LContestSheenTooHigh_0 = けづやは <= {0} でなければなりません。
LContestSheenTooLow_0 = けづやは >= {0} でなければなりません。
LContestZero = コンディションは0でなければなりません。
LContestZeroSheen = けづやは0でなければなりません。
LDateOutsideDistributionWindow = 出会った日が配布期間外です。
LEffort2Remaining = 努力値が2残っています。
LEffortAbove252 = 努力値は1つにつき252までです。
LEffortAbove510 = 努力値の合計は510までです。
LEffortAllEqual = 努力値は全て等しいです。
LEffortCap100 = 第４世代で出会ったレベルが100の場合、努力値はそれぞれ100を超えることはできません。
LEffortEgg = タマゴに努力値を振ることはできません。
LEffortEXPIncreased = 努力値は全て0ですが、出会ったレベルを超えています。
LEffortShouldBeZero = 努力値を振ることはできません。
LEffortUntrainedCap = 経験値を得ていないポケモンの努力値は {0} を超えることはできません。
LEggContest = タマゴはコンディションを上げることはできません。
LEggEXP = タマゴは経験値を得ることはできません。
LEggFMetLevel_0 = 出会ったレベルが無効です。 {0} にしてください。
LEggHatchCycles = 孵化サイクルが無効です。
LEggLocation = 出会った場所でタマゴを孵化させることが可能です。
LEggLocationInvalid = 出会った場所でタマゴを孵化させることができません。
LEggLocationNone = もらった場所が無効です。
LEggLocationPalPark = 出会った場所が無効です、パルパークにする必要があります。
LEggLocationTrade = 出会った場所で交換したタマゴを孵化させることができます。
LEggLocationTradeFail = もらった場所が無効です。タマゴの状態で交換してはいけません。
LEggMetLocationFail = そのもらった場所では、タマゴを入手できません。
LEggNature = タマゴはミントで性格変更できません。
LEggPokeathlon = タマゴはポケスロンのステータスを変更できません。
LEggPokerus = タマゴはポケルスに感染しません。
LEggPP = タマゴは技のPPを変更することはできません。
LEggPPUp = タマゴにポイントアップは使用できません
LEggRelearnFlags = 技を思い出すフラグがないと思われます。
LEggShinyLeaf = タマゴに『かがやくはっぱ/冠』を設定することはできません。
LEggShinyPokeStar = タマゴにポケウッドのスターを付与することはできません。
LEggSpecies = このポケモンのタマゴは入手できません。
LEggUnhatched = 孵化していない正規のタマゴ。
LEncCondition = 正規の場所で会った野生のポケモン。
LEncConditionBadRNGFrame = Unable to match encounter conditions to a possible RNG frame.
LEncConditionBadSpecies = このポケモンはこのゲームに登場しません。
LEncConditionBlack = 正規な場所(くろいビードロ使用)での野生産ポケモンです。
LEncConditionBlackLead = 正規な場所(くろいビードロやプレッシャー/はりきり/やるき)での野生産ポケモンです。
LEncConditionDexNav = 正規な場所(ずかんナビ)での野生産ポケモンです。
LEncConditionLead = 正規な場所(プレッシャー/はりきり/やるき)での野生産ポケモンです。
LEncConditionWhite = 正規な場所(しろいビードロ使用)での野生産ポケモンです。
LEncConditionWhiteLead = 正規な場所(しろいビードロやプレッシャー/はりきり/やるき)での野生産ポケモンです。
LEncGift = 元々のゲームでのタマゴのエンカウントと一致しません。
LEncGiftEggEvent = 元々のゲームのタマゴイベントのエンカウントと一致しません。
LEncGiftIVMismatch = ふしぎなおくりものデータベースの個体値と一致しません。
LEncGiftNicknamed = イベントで入手できるポケモンにニックネームがつけられています。
LEncGiftNotFound = ふしぎなおくりものデータベースと一致しません。
LEncGiftPIDMismatch = ふしぎなおくりものの性格値不一致を修正しました。
LEncGiftShinyMismatch = ふしぎなおくりものデータベースとの色(色違い)が一致しません。
LEncGiftVersionNotDistributed = このバージョンではふしぎなおくりものを受け取れません。
LEncInvalid = エンカウントエラー
LEncMasteryInitial = 予想されるエンカウントと技の皆伝状況が一致しません。
LEncStaticMatch = イベント/固定シンボル等
LEncStaticPIDShiny = 固定シンボルエンカウント等の色（色違いか）が一致しません。
LEncStaticRelearn = 固定シンボルエンカウント等の思い出し技が一致しません。
LEncTradeChangedNickname = ゲーム内交換のニックネームが変更されています。
LEncTradeChangedOT = ゲーム内交換の親名が変更されています。
LEncTradeIndexBad = In-game Trade invalid index?
LEncTradeMatch = 正規のゲーム内交換。
LEncTradeUnchanged = ゲーム内交換：元のトレーナーとニックネームは変更されていません。
LEncTypeMatch = エンカウントタイプが一致。
LEncTypeMismatch = エンカウントタイプが一致しません。
LEncUnreleased = 未解禁イベント
LEncUnreleasedEMewJP = 日本産以外のさいはてのことう産ミュウは解禁されていません。
LEncUnreleasedHoOArceus = はじまりのま産アルセウスは解禁されていません。
LEncUnreleasedPtDarkrai = プラチナ以外のダークライは解禁されていません。
LEncUnreleasedPtShaymin = プラチナ以外のシェイミは解禁されていません。
LEReaderAmerica = 日本のセーブデータに海外産のナゾのみが存在します。
LEReaderInvalid = このナゾのみは無効です。
LEReaderJapan = 海外のセーブデータに、日本産のナゾのみが存在します。
LEvoInvalid = その進化は無効です。（レベルが満たない/通信進化が必要）
LEvoTradeReq = ゲーム内交換により {0} は {1} に進化します。
LEvoTradeReqOutsider = 交換した {0} は必ず {1} に進化します。
LEvoTradeRequired = バージョン固有の進化には、もう一方のバージョンへの交換が必要です。
LFateful = ゲーム内でのうんめいてきなであいポケモン。
LFatefulGiftMissing = 一致する出会いがない、うんめいてきなであいポケモンです。ふしぎなおくりものデータはありますか？
LFatefulInvalid = 『うんめいてきなであい』のチェックを外してください。
LFatefulMissing = 『うんめいてきなであい』にチェックを入れてください。
LFatefulMystery = ふしぎなおくりもの産の『うんめいてきなであい』
LFatefulMysteryMissing = 『うんめいてきなであい』にチェックを入れてください。
LFavoriteMarkingUnavailable = お気に入りマークは使用できません。
LFormArgumentHigh = フォルムの引数が現在のフォルムには高すぎます。
LFormArgumentInvalid = フォルムの引数が無効です。
LFormArgumentLow = フォルムの引数が現在のフォルムには低すぎます。
LFormArgumentNotAllowed = このエンカウントタイプでは、フォルムの引数は許可されていません。
LFormArgumentValid = フォルムの引数は有効です。
LFormBattle = このフォルムはバトル中以外では存在できません。
LFormEternal = 有効なえいえんのはな個体。
LFormEternalInvalid = 無効なえいえんのはな個体。
LFormInvalidExpect_0 = フォルムは不正です。フォルムのインデックスを {0} にしてください。
LFormInvalidGame = このフォルムは元々のゲームでは獲得できません。
LFormInvalidNature = フォルムと性格が不一致です。
LFormInvalidRange = フォルムの数が範囲外です。予想：<= {0},取得したのは {1} です。
LFormItem = 持ち物とフォルムは一致しています。
LFormItemInvalid = 持ち物とフォルムが一致しません。
LFormParty = このフォルムは手持ちの外では存在できません。
LFormPikachuCosplay = このフォルムはおきがえピカチュウのみがなれます。
LFormPikachuCosplayInvalid = おきがえピカチュウは通常フォルムにはなれません。
LFormPikachuEventInvalid = イベント（帽子）ピカチュウは通常フォルムにはなれません。
LFormValid = フォルムは正常です。
LFormVivillon = 正常なビビヨンの模様。
LFormVivillonEventPre = 進化前のビビヨンのイベント模様。
LFormVivillonInvalid = 不正なビビヨンの模様。
LFormVivillonNonNative = Non-native Vivillon pattern.
LG1CatchRateChain = 捕獲率がどのポケモンの進化パターンとも一致しません。
LG1CatchRateEvo = 野生以外で捕獲したポケモンの捕獲率。進化前の捕獲率を想定されます。
LG1CatchRateItem = 捕獲率が第２世代の正規の持ち物と一致しません。
LG1CatchRateMatchPrevious = 捕獲率がポケモンの進化パターンと一致します。
LG1CatchRateMatchTradeback = 捕獲率が第２世代の正規の持ち物と一致します。
LG1CatchRateNone = 捕獲率がポケモンの進化パターンや、第２世代の持ち物とも一致しません。
LG1CharNick = 第1世代、第２世代では使用できない文字がニックネームに含まれています。
LG1CharOT = 第1世代、第２世代では使用できない文字がトレーナー名に含まれています
LG1GBEncounter = VCでは特別なポケモンは入手できません。
LG1MoveExclusive = 第１世代専用の技。タイムカプセルを使用する技と両立できません。
LG1MoveLearnSameLevel = 両立できない技。赤/緑とピカチュウで同じレベルで覚えます。
LG1MoveTradeback = タイムカプセルを使用しないタマゴ技。第１世代の専用技とは両立できません。
LG1OTEvent = 第１世代イベントでのトレーナー名が正しく有りません。
LG1OTGender = 第1世代、第2世代では女性トレーナーは選択できません。
LG1Stadium = ポケモンスタジアムのトレーナー名が間違っています。
LG1StadiumInternational = 正規の海外版のポケモンスタジアムのトレーナー名。
LG1StadiumJapanese = 正規の日本のポケモンスタジアムのトレーナー名。
LG1TradebackPreEvoMove = タイムカプセルをしていない進化前技。第１世代の専用技とは両立できません。
LG1Type1Fail = 不正のタイプA、種族タイプと一致しません。
LG1Type2Fail = 不正のタイプB、種族タイプと一致しません。
LG1TypeMatch1 = 正規のタイプA、種族タイプと一致します。
LG1TypeMatch2 = 正規のタイプB、種族タイプと一致します。
LG1TypeMatchPorygon = タイプAとBの値を持つ正規なポリゴン。
LG1TypePorygonFail = タイプAとBの値を持つ不正なポリゴン。有効な組み合わせと一致しません。
LG1TypePorygonFail1 = タイプAの値を持つ不正なポリゴン。
LG1TypePorygonFail2 = タイプBの値を持つ不正なポリゴン。
LG2InvalidTilePark = しぜんこうえん（２世代）の釣りエンカウント。正規では到達できない場所。
LG2InvalidTileR14 = １４ばんどうろ（２世代）の釣りエンカウント。正規では到達できない場所。
LG2InvalidTileSafari = 第２世代のサファリゾーンでの釣りエンカウント。正規では到達不可能。
LG2InvalidTileTreeID = トレーナーIDと一致するクリスタルの頭突きエンカウントの木（到達不可）が見つかりました。
LG2InvalidTileTreeNotFound = トレーナーIDと一致するクリスタルの頭突きエンカウントの木が見つかりませんでした。
LG2OTGender = クリスタル以外の２世代以前のポケモンは女性トレーナーは選択できません。
LG2TreeID = トレーナーIDと一致するクリスタルの頭突きエンカウントの木が見つかりました。
LG3EReader = 日本以外でカードeリーダーを使ったダークポケモン。未実装のエンカウント。
LG3OTGender = 「ポケモンコロシアム」「ポケモンＸＤ」では女性トレーナーは選択できません
LG4InvalidTileR45Surf = ４５ばんどうろ（４世代）の水上エンカウント。正規では到達不可能です。
LG5ID_N = Nの名前/表ID/裏IDが正しくありません。
LG5IVAll30 = Nのポケモンは個体値が全て30です。
LG5OTGenderN = Nのポケモンはトレーナーの性別が必ず男でなければなりません。
LG5PIDShinyGrotto = 隠し穴産のポケモンは色違いになりません。
LG5PIDShinyN = Nのポケモンは色違いは存在しません。
LG5SparkleInvalid = Nのポケモンフラグのチェックを外してください。
LG5SparkleRequired = Nのポケモンフラグのチェックを入れてください。
LGanbaruStatTooHigh = １つ以上のがんばレベルが通常限界値（10-個体値ボーナス）を超えています。
LGenderInvalidNone = 性別不明のポケモンは性別を持ちません。
LGeoBadOrder = 地域（おもいで）:空白があります。
LGeoHardwareInvalid = 地域設定:この国は3DS地域設定にありません。
LGeoHardwareRange = 不正な地域
LGeoHardwareValid = 地域設定:この国は3DS地域設定にあります。
LGeoMemoryMissing = 地域設定（おもいで）: おもいでがありません。
LGeoNoCountryHT = 地域設定（おもいで）: トレーナー名が存在しますが、国の設定がされていません。
LGeoNoRegion = 地域設定（おもいで）: 国設定なしに地域設定されています。
LHyperPerfectAll = 全ての個体値が31のためすごいとっくんはできません。
LHyperPerfectOne = 個体値31にはすごいとっくんはできません。
LHyperPerfectUnavailable = 現在の個体値ではもうすごいとっくんはできません。
LHyperTooLow_0 = すごいとっくんをするにはレベル{0}でなければなりません。
LItemEgg = タマゴはアイテムを持てません。
LItemUnreleased = この持ち物は解禁されていません。
LIVAllEqual_0 = 個体値は全て {0} です。
LIVF_COUNT0_31 = 少なくとも {0} つの個体値31が必要です。
LIVNotCorrect = 個体値がエンカウントタイプと一致しません。
LLevelEXPThreshold = 現在の経験値がレベルのしきい値と一致しています。
LLevelEXPTooHigh = 現在の経験値が100レベルの最大値を超えています。
LLevelMetBelow = 現在のレベルが出会ったレベルより低いです。
LLevelMetGift = ふしぎなおくりもので出会ったレベルと一致しません。
LLevelMetGiftFail = ふしぎなおくりもので出会ったレベルを下回っています。
LLevelMetSane = 出会った時のレベルより現在のレベルが下回っています。
LMarkValueOutOfRange_0 = Individual marking at index {0} is not within the allowed value range.
LMarkValueShouldBeZero = マーキングフラグが設定できません。
LMarkValueUnusedBitsPresent = マーキングフラグはアクセう可能な範囲を超えたビットを使用しています。
LMemoryArgBadCatch = {0} おもいで: {0} は捕獲できません。
LMemoryArgBadHatch = {0} おもいで: {0} は孵化できません。
LMemoryArgBadHT = おもいで: Can't have Handling Trainer Memory as Egg.
LMemoryArgBadID = {0} おもいで: Can't obtain Memory on {0} Version.
LMemoryArgBadItem = {0} おもいで: Species can't hold this item.
LMemoryArgBadLocation = {0} Memory: Can't obtain Location on {0} Version.
LMemoryArgBadMove = {0} Memory: Species can't learn this move.
LMemoryArgBadOTEgg = {0} Memory: Link Trade is not a valid first memory.
LMemoryArgBadSpecies = {0} Memory: Can't capture species in game.
LMemoryArgSpecies = {0} Memory: Species can be captured in game.
LMemoryCleared = Memory: Not cleared properly.
LMemoryF_0_Valid = {0} Memory is valid.
LMemoryFeelInvalid = {0} Memory: Invalid Feeling.
LMemoryHTFlagInvalid = Untraded: Current handler should not be the Handling Trainer.
LMemoryHTGender = HT Gender invalid: {0}
LMemoryHTLanguage = HT Language is missing.
LMemoryIndexArgHT = Should have a HT Memory TextVar value (somewhere).
LMemoryIndexFeel = {0} Memory: Feeling should be index {1}.
LMemoryIndexFeelHT09 = Should have a HT Memory Feeling value 0-9.
LMemoryIndexID = {0} Memory: Should be index {1}.
LMemoryIndexIntensity = {0} Memory: Intensity should be index {1}.
LMemoryIndexIntensityHT1 = Should have a HT Memory Intensity value (1st).
LMemoryIndexIntensityMin = {0} Memory: Intensity should be at least {1}.
LMemoryIndexLinkHT = Should have a Link Trade HT Memory.
LMemoryIndexVar = {0} Memory: TextVar should be index {1}.
LMemoryMissingHT = Memory: Handling Trainer Memory missing.
LMemoryMissingOT = Memory: Original Trainer Memory missing.
LMemorySocialTooHigh_0 = Social Stat should be <= {0}
LMemorySocialZero = Social Stat should be zero.
LMemoryStatAffectionHT0 = Untraded: Handling Trainer Affection should be 0.
LMemoryStatAffectionOT0 = OT Affection should be 0.
LMemoryStatEnjoyment = Enjoyment should be {0}.
LMemoryStatFriendshipHT0 = 未交換: 現在のトレーナーとのなつき度は0である必要があります。
LMemoryStatFriendshipOTBaseEvent = Event OT Friendship does not match base friendship.
LMemoryStatFullness = まんぷく度は {0} である必要があります。
LMetDetailTimeOfDay = 出会った時間が予想された範囲内にありません。
LMoveEggFIncompatible0_1 = {0} タマゴ技。 {1} のタマゴ技と両立できません。
LMoveEggIncompatible = タマゴ技。イベントによるタマゴ技と両立できません。
LMoveEggIncompatibleEvent = イベントによるタマゴ技。通常のタマゴ技と両立できません。
LMoveEggInherited = 遺伝可能なタマゴ技
LMoveEggInheritedTutor = 遺伝可能な教え技
LMoveEggInvalid = タマゴ技がありません。
LMoveEggInvalidEvent = タマゴ技。イベントによるタマゴではありません。
LMoveEggInvalidEventLevelUp = 遺伝可能なレベルアップ技。イベントによるタマゴではありません。
LMoveEggInvalidEventLevelUpGift = 遺伝可能なレベルアップ技。もらったタマゴではありません。
LMoveEggInvalidEventTMHM = 遺伝可能なわざマシン/ひでんマシン技。イベントによるタマゴではありません。
LMoveEggInvalidEventTutor = 遺伝可能な教え技。イベントによるタマゴではありません。
LMoveEggLevelUp = 遺伝可能なレベルアップ技
LMoveEggMissing = イベントによるタマゴ技がありません。
LMoveEggMoveGift = タマゴ技。もらったタマゴではありません。
LMoveEggTMHM = 遺伝可能なわざマシン/ひでんマシン技。
LMoveEventEggLevelUp = 遺伝可能なレベルアップ技。イベントによるタマゴ技と両立できません。
LMoveEvoFCombination_0 = 技の組み合わせは {0} 進化と両立できません。
LMoveEvoFHigher = 両立できない進化技。 {1} の技は他の {0} の技よりも高いレベルで習得します。
LMoveEvoFLower = 両立できない進化技。 {0} の技は他の {1} の技よりも低いレベルで習得します。
LMoveFDefault_0 =  {0} 世代の通常技。
LMoveFExpect_0 = 次のような技が予想されます: {0}
LMoveFExpectSingle_0 = 予想: {0}
LMoveFLevelUp_0 =  {0} 世代のレベルアップ技です。
LMoveFTMHM_0 =  {0} 世代のわざマシン/ひでんマシン技です。
LMoveFTutor_0 =  {0} 世代の教え技です。
LMoveKeldeoMismatch = ケルディオの技/フォルムが一致しません。
LMoveNincada = テッカニンの技は１つだけ覚えることが可能です。
LMoveNincadaEvo = テッカニンに進化させる際に、覚えられます。
LMoveNincadaEvoF_0 = {0} 世代でテッカニンに進化させる際、覚えられます。
LMovePPTooHigh_0 = 技 {0} のPPが上限を超えています。
LMovePPUpsTooHigh_0 = 技 {0} のポイントアップ上限を超えています。
LMoveRelearnDexNav = ずかんナビによる技ではありません。
LMoveRelearnEgg = ベースのタマゴ技
LMoveRelearnEggMissing = ベースのタマゴ技を設定してください
LMoveRelearnFExpect_0 = 次の技のいずれかを思い出し技に設定してください: {0} ({1})
LMoveRelearnFMiss_0 = 思い出し技がありません: {0}
LMoveRelearnInvalid = 思い出し可能な技がありません。
LMoveRelearnNone = 思い出し技が設定されていません。
LMoveRelearnUnderground = 地下大洞窟のタマゴ技がありません。
LMoveShopAlphaMoveShouldBeMastered = オヤブン技は皆伝マークがなければなりません。
LMoveShopAlphaMoveShouldBeOther = このオヤブン技では、オヤブンのエンカウントを調べることができません。
LMoveShopAlphaMoveShouldBeZero = オヤブンのみがオヤブン技を持つことが出来ます。
LMoveShopMasterInvalid_0 =  {0} は手動で皆伝できません: 皆伝することはできません。
LMoveShopMasterNotLearned_0 = {0} は手動で皆伝できません: レベルアップで習得可能な技はありません。
LMoveShopPurchaseInvalid_0 = 技教えから {0} を習得できません。 
LMoveSourceDefault = 通常技
LMoveSourceDuplicate = 重複した技
LMoveSourceEgg = タマゴ技
LMoveSourceEggEvent = イベントによるタマゴ技
LMoveSourceEmpty = 技が設定されていません。
LMoveSourceInvalid = この技は習得できません。
LMoveSourceInvalidSketch = この技は習得できません（スケッチ）。
LMoveSourceLevelUp = レベルアップ技
LMoveSourceRelearn = 思い出し技
LMoveSourceShared = 思い出しできない技
LMoveSourceSharedF =  {0} 世代の思い出しできない技
LMoveSourceSpecial = 思い出しできない特別な技
LMoveSourceTMHM = わざマシン/ひでんマシンで習得した。
LMoveSourceTR = 想定外のわざレコードフラグ: {0}
LMoveSourceTutor = 技教えで習得した。
LNickFlagEggNo = タマゴにニックネームは付けられません。
LNickFlagEggYes = タマゴにニックネームは付ける必要があります。
LNickInvalidChar = このニックネームは付けられません。
LNickLengthLong = ニックネーム文字数が超過しています。
LNickLengthShort = ニックネームが空白です。
LNickMatchLanguage = 名前が種族名と一致します。
LNickMatchLanguageEgg = 名前が『タマゴ』です。
LNickMatchLanguageEggFail = 名前が『タマゴ』ではありません。
LNickMatchLanguageFail = ニックネームが種族名と一致しません。
LNickMatchLanguageFlag = ニックネームフラグが立ち、種族名と一致します。
LNickMatchNoOthers = ニックネームが別のポケモン名と一致しません。
LNickMatchNoOthersFail = ニックネームは別のポケモンの名前(+言語)と一致します。
LOT_IDEqual = 表IDと裏IDが同じです。
LOT_IDInvalid = その表IDと裏ID組み合わせは不正です。
LOT_IDs0 = 表IDと裏IDが0です。
LOT_SID0 = 裏IDが0です。
LOT_SID0Invalid = 裏IDは「00000」でなければなりません。
LOT_TID0 = 表IDが0です。
LOTLanguage = 言語IDは {1} ではなく、 {0} である必要があります。
LOTLong = トレーナー名の文字数が超過しています。
LOTShort = トレーナー名が空白です。
LOTSuspicious = 疑わしいトレーナーの詳細です。
LPIDEncryptWurmple = ケムッソの進化による暗号化定数が不一致です。
LPIDEncryptZero = 暗号化定数が設定されていません。
LPIDEqualsEC = 暗号化定数と性格値が同じです。
LPIDGenderMatch = 性別と性格値が一致しています。
LPIDGenderMismatch = 性別と性格値が一致しません。
LPIDNatureMatch = 性格と性格値は一致しています。
LPIDNatureMismatch = 性格と性格値が一致しません。
LPIDTypeMismatch = エンカウントタイプと性格値が一致しません。
LPIDZero = 性格値が設定されていません。
LPokerusDaysTooHigh_0 = ポケルスの残り日数が多すぎます; 範囲 <= {0}.
LPokerusStrainUnobtainable_0 = ポケルス株 {0} は取得できません。
LRibbonAllValid = 全てのリボンからなっている
LRibbonEgg = タマゴにリボンは設定できません。
LRibbonFInvalid_0 = 無効なリボンが設定されています: 
LRibbonFMissing_0 = 次のリボンが不足しています: 
LRibbonMarkingAffixedF_0 = 無効なリボン/マーキングが設定されています: {0}
LRibbonMarkingFInvalid_0 = 無効なマーキング: {0}
LStatAlphaInvalid = オヤブンフラグ不一致。
LStatBattleVersionInvalid = バトルバージョンは予想の範囲内ではありません。
LStatDynamaxInvalid = ダイマックスレベルが範囲外です。
LStatGigantamaxInvalid = キョダイマックスフラグの不一致。
LStatGigantamaxValid = ダイスープによってキョダイマックスフラグが変更されました。
LStatIncorrectCP = 計算されたCPが保存値と一致しません。
LStatIncorrectHeight = 計算された高さが保存値と一致しません。
LStatIncorrectHeightCopy = コピーした高さが元の高さと一致しません。
LStatIncorrectHeightValue = 高さが範囲と一致しません。
LStatIncorrectWeight = 計算された重さが保存値と一致しません。
LStatIncorrectWeightValue = 重さが範囲と一致しません。
LStatInvalidHeightWeight = 高さ/重さの数値が可能範囲を超えています。
LStatNatureInvalid = ミント性格補正が予想の範囲内にありません。
LStatNobleInvalid = キング/クイーンのフラグが不一致。
LSuperComplete = スパトレのクリアフラグが矛盾しています。
LSuperDistro = 配信限定スパトレはリリースされていません。
LSuperEgg = タマゴはスパトレができません。
LSuperNoComplete = Can't have active Super Training complete flag for origins.
LSuperNoUnlocked = Can't have active Super Training unlocked flag for origins.
LSuperUnavailable = Super Training missions are not available in games visited.
LSuperUnused = 未使用のスパトレにフラグが立っています。
LTeraTypeIncorrect = テラスタルタイプが一致しません。
LTeraTypeMismatch = テラスタルタイプが元のタイプのいずれにも一致しません。
LTradeNotAvailable = Encounter cannot be traded to the active trainer.
LTransferBad = VCからポケモンを入手できません。
LTransferCurrentHandlerInvalid = 不正なトレーナーの値です。トレーナー情報に他の値を入力してください。
LTransferEgg = 世代間でタマゴを送ることはできません。
LTransferEggLocationTransporter = 出会った場所が不正です。世代を超えてポケモンを送る必要があります。
LTransferEggMetLevel = 送られてきたポケモンの出会ったレベルが不正です。
LTransferFlagIllegal = 不正にフラグが立てられています。（バグの悪用）
LTransferHTFlagRequired = 旧世代のポケモンで、親を過去のトレーナーの方にしています。
LTransferHTMismatchGender = Handling trainer does not match the expected trainer gender.
LTransferHTMismatchLanguage = 先のトレーナーと予想されるトレーナーの言語が一致しません。
LTransferHTMismatchName = 先のトレーナーと予想されるトレーナー名が一致しません。
LTransferMet = 出会った場所が不正です。原因はポケシフターかクラウンポケモンだと思われます。
LTransferMetLocation = 転送後の出会った場所が不正です。
LTransferMove = 転送して両立できない技です。
LTransferMoveG4HM = きりばらいかうずしおのどちらかを５世代に送る前に忘れさせてください。
LTransferMoveHM = {0} 世代のひでんマシンを覚えたポケモンは {1} 世代に送るために忘れさせなければなりません。
LTransferNature = 転送されたポケモンには不正な性格です。
LTransferNotPossible = 元のフォーマットから現在のフォーマットに転送できません。
LTransferObedienceLevel = 不正な従順レベルです。
LTransferOriginFInvalid0_1 = {0} は現在ロードされている ({1}) セーブファイルに存在できません。
LTransferPIDECBitFlip = 性格値は暗号化定数と（上位ビットを反転して）同じにする必要があります。
LTransferPIDECEquals = 性格値は暗号化定数と同じにする必要があります。
LTransferPIDECXor = 暗号化定数と色違い性格値が一致します。
LTransferTrackerMissing = HOME Trackerが見つかりません。
LTransferTrackerShouldBeZero = HOME Trackerを０にしてください。
LTrashBytesExpected = Expected Trash Bytes.
LTrashBytesExpected_0 = Expected Trash Bytes: {0}
LTrashBytesMismatchInitial = Expected initial trash bytes to match the encounter.
LTrashBytesMissingTerminator = Final terminator missing.
LTrashBytesShouldBeEmpty = Trash Bytes should be cleared.
LTrashBytesUnexpected = Unexpected Trash Bytes.
