L_AError = 內部錯誤。
L_ALegal = 合法。
L_AnalysisUnavailable = 無法解析此寶可夢。
L_AValid = 有效。
L_F0_1 = {0}: {1}
L_F0_M_1_2 = {0}招式 {1} : {2}
L_F0_RM_1_2 = {0}可回憶招式 {1}: {2}
L_FEncounterType_0 = 遇見方式: {0}
L_FOriginSeed_0 = 原始 Seed: {0}
L_FPIDType_0 = PID類型: {0}
L_SFishy = 可疑
L_SInvalid = 不合法
L_SNotImplemented = 功能尚未實現
L_SValid = 合法
L_XEnigmaBerry_0 = {0}果
L_XHT = 持有人
L_XKorean = 韓版
L_XKoreanNon = 非韓版
L_XLocation = Location
L_XMatches0_1 = 匹配: {0} {1}
L_XNickname = Nickname
L_XOT = 初訓家
L_XRareFormEvo_0_1 = 將進化為「{0}」形態(該寶可夢種類之「{1}」形態更爲稀有)
L_XWurmpleEvo_0 = 刺尾蟲進化形態: {0}
LAbilityCapsuleUsed = 特性經已透過特性膠囊改變。
LAbilityFlag = 特性與特性序號匹配。
LAbilityHiddenFail = 隱藏特性與遇見方式不匹配。
LAbilityHiddenUnavailable = 隱藏特性不可獲得。
LAbilityMismatch = 特性與遇見方式不匹配。
LAbilityMismatch3 = 特性與第三世代種類特性不匹配。
LAbilityMismatchFlag = 特性與特性值不匹配。
LAbilityMismatchGift = 特性與神秘禮物記載數據不匹配。
LAbilityMismatchGrotto = 隱藏洞穴捕獲之寶可夢必定為隱藏特性。
LAbilityMismatchHordeSafari = 非群戰/朋友原野區獲得隱藏特性。
LAbilityMismatchPID = 特性與 PID 記載數據不匹配。
LAbilityMismatchSOS = 非幫手寶可夢擁有隱藏特性。
LAbilityPatchRevertUsed = 特性經已透過特性膏藥還原。
LAbilityPatchUsed = 特性經已透過特性膏藥改變。
LAbilityUnexpected = 特性對於該種類/形態不合法。
LAwakenedCap = 單個覺醒值不能大於 {0}。
LAwakenedShouldBeValue = 單個覺醒值應該大於 {0} ({1})。
LBallAbility = 不能使用該球種捕獲此種隱藏特性寶可夢。
LBallEggCherish = 普通蛋之球種不能為貴重球。
LBallEggMaster = 普通蛋之球種不能為大師球。
LBallEnc = 可使用此球種獲得該遇見方式寶可夢。
LBallEncMismatch = 不可使用此球種獲得該遇見方式寶可夢。
LBallHeavy = 體重輕且低捕獲率之寶可夢無法被沉重球所捕獲（第七世代）。
LBallNone = 未檢查到滿足條件之資訊，因而假設為不合法。
LBallSpecies = 無法使用此球種捕獲該寶可夢。
LBallSpeciesPass = 可使用此球種捕獲該種類寶可夢。
LBallUnavailable = 於此寶可夢出身游戲世代中，該球種不可獲得。
LContestSheenTooHigh_0 = 華麗大賽光澤度應小於或等於「 {0} 」。
LContestSheenTooLow_0 = 華麗大賽光澤度應大於或等於「 {0} 」。
LContestZero = 華麗大賽狀態值應置「0」。
LContestZeroSheen = 華麗大賽光澤度應置「0」。
LDateOutsideDistributionWindow = 遇見日期於神秘禮物配信期間之外。
LEffort2Remaining = 仍餘下2點努力值尚未分配。
LEffortAbove252 = 單項努力值不能超過「252」。
LEffortAbove510 = 努力值總和不能超過「510」。
LEffortAllEqual = 所有努力值相等。
LEffortCap100 = 對於遇見等級為100之四代寶可夢,單項努力值不能大於「100」。
LEffortEgg = 蛋不能擁有努力值。
LEffortEXPIncreased = 所有努力值為0，但當前等級高於遇見等級。
LEffortShouldBeZero = 無法獲得努力值。
LEffortUntrainedCap = 寶可夢擁有努力值，但尚未獲得超過{0}之經驗值。
LEggContest = 不能調整蛋之華麗大賽狀態。
LEggEXP = 蛋不能獲得經驗值。
LEggFMetLevel_0 = 不合法之遇見等級, 應於「 {0} 」級時遇見該寶可夢。
LEggHatchCycles = 蛋剩餘孵化週期不合法。
LEggLocation = 可於遇見地點孵化蛋。
LEggLocationInvalid = 不能於遇見地點孵化蛋。
LEggLocationNone = 不合法之蛋取得場所, 應該為「空」。
LEggLocationPalPark = 不合法之遇見地點, 應於「夥伴公園」遇見該寶可夢。
LEggLocationTrade = 可於遇見地點孵化「連線交換」所得蛋。
LEggLocationTradeFail = 不合法之蛋取得場所, 無法於寶可夢仍是蛋時「連線交換」。
LEggMetLocationFail = 無法於設定之蛋取得場所獲得該蛋。
LEggNature = 無法使用「薄荷」修正蛋之性格。
LEggPokeathlon = 蛋不能有全能競技賽體能值。
LEggPokerus = 蛋不能感染寶可病毒。
LEggPP = 蛋不能修改 PP 值。
LEggPPUp = 不能對蛋使用 PP 提升劑。
LEggRelearnFlags = 預期不會重新學習技能標記。
LEggShinyLeaf = 蛋不能携帶閃耀的葉片/王冠。
LEggShinyPokeStar = 蛋無法成為寶可夢好萊塢之星。
LEggSpecies = 不能獲得該種寶可夢之蛋。
LEggUnhatched = 合法孵化之蛋。
LEncCondition = 合法野外遇見方式。
LEncConditionBadRNGFrame = 遇見方式可能無法與可行之亂數幀相匹配。
LEncConditionBadSpecies = 該寶可夢於出身游戲中不存在。
LEncConditionBlack = 合法野外遇見方式 (黑色玻璃哨)。
LEncConditionBlackLead = 合法野外遇見方式 (黑色玻璃哨 & 壓迫感/活力/幹勁)。
LEncConditionDexNav = 合法野外遇見方式 (忍足系統)。
LEncConditionLead = 合法野外遇見方式 (壓迫感/活力/幹勁)。
LEncConditionWhite = 合法野外遇見方式 (白色玻璃哨)。
LEncConditionWhiteLead = 合法野外遇見方式 (白色玻璃哨 & 壓迫感/活力/幹勁)。
LEncGift = 無法於出身游戲中匹配到相應之神秘禮物蛋。
LEncGiftEggEvent = 無法於出身游戲中匹配到相應之神秘禮物蛋。
LEncGiftIVMismatch = 個體值與神秘禮物記載資料不匹配。
LEncGiftNicknamed = 神秘禮物配信寶可夢經已修改過昵稱。
LEncGiftNotFound = 不能與資料庫中神秘禮物資料匹配。
LEncGiftPIDMismatch = 神秘禮物記載數據與 PID 不匹配。
LEncGiftShinyMismatch = 神秘禮物記載數據與異色狀態不匹配。
LEncGiftVersionNotDistributed = 不能於此游戲版本中接收該神秘禮物。
LEncInvalid = 不能於出身游戲中匹配到對應遇見方式。
LEncMasteryInitial = 初始精通技能標識無法與期望狀態匹配。
LEncStaticMatch = 合法之神秘禮物/定點遇見。
LEncStaticPIDShiny = 定點遇見類型寶可夢之異色條件不匹配。
LEncStaticRelearn = 定點遇見寶可夢之可回憶招式不匹配。
LEncTradeChangedNickname = 遊戲內連線交換之昵稱經已修改。
LEncTradeChangedOT = 遊戲內連線交換之初訓家經已修改。
LEncTradeIndexBad = 遊戲內連線交換序號不合法?
LEncTradeMatch = 合法之遊戲內連線交換。
LEncTradeUnchanged = 遊戲內連線交換之初訓家和昵稱未被修改。
LEncTypeMatch = 遇見類型與資料記載之遇見方式匹配。
LEncTypeMismatch = 遇見類型與資料記載之遇見方式不匹配。
LEncUnreleased = 未解禁之神秘禮物。
LEncUnreleasedEMewJP = 非日版游戲來自邊境小島之夢幻，未發佈之配信。
LEncUnreleasedHoOArceus = 來自初始之間的阿爾宙斯，未發佈之配信。
LEncUnreleasedPtDarkrai = 非白金版游戲來自新月島之達克萊伊，未發佈之配信。
LEncUnreleasedPtShaymin = 非白金版游戲來自花之樂園的謝米，未發佈之配信。
LEReaderAmerica = 美版E-Reader樹果載入到了日版儲存資料中。
LEReaderInvalid = 不合法E-Reader樹果。
LEReaderJapan = 日版E-Reader樹果載入到了國際版儲存資料中。
LEvoInvalid = 應暫無法進化為此寶可夢（可能由於等級，通訊進化或其餘條件未滿足）。
LEvoTradeReq = 遊戲內連線交換「{0}」應通訊進化進化為「{1}」。
LEvoTradeReqOutsider = 外來之「{0}」應當進化為「{1}」。
LEvoTradeRequired = 該特定進化為版本獨占，須交換至另一版本中進化，因而須有現時持有人資訊。
LFateful = 遊戲內特殊寶可夢應有「命中注定般地遇見」之標識。
LFatefulGiftMissing = 缺乏匹配之「命中注定般地遇見」資料。此神秘禮物有被共用分享至資料庫嗎?
LFatefulInvalid = 「命中注定般地遇見」不應被勾選。
LFatefulMissing = 遊戲內特殊寶可夢缺失「命中注定般地遇見」之標識。
LFatefulMystery = 神秘禮物寶可夢應有「命中注定般地遇見」之標識。
LFatefulMysteryMissing = 神秘禮物缺失「命中注定般地遇見」之標識。
LFavoriteMarkingUnavailable = 最喜歡之標記不可用。
LFormArgumentHigh = 形態參數對於當前形態而言數值過高。
LFormArgumentInvalid = 形態參數無效。
LFormArgumentLow = 形態參數對於當前形態而言數值過低。
LFormArgumentNotAllowed = 當前遇見方式不應為此形態參數。
LFormArgumentValid = 形態參數有效。
LFormBattle = 該形態無法存在對戰外。
LFormEternal = 永恆之花遇見合法。
LFormEternalInvalid = 永恆之花遇見不合法。
LFormInvalidExpect_0 = 此形態不合法，預期之形態編號應為「 {0} 」。
LFormInvalidGame = 此形態不能於出身游戲中獲得。
LFormInvalidNature = 此形態無法擁有該種性格。
LFormInvalidRange = 形態數超過最大值。 應該 <=「 {0} 」, 實際是「 {1} 」。
LFormItem = 持有物與形態匹配。
LFormItemInvalid = 持有物與現時形態不匹配（可能此形態僅於持有某種持有物時生效）。
LFormParty = 該形態不可於同行隊伍外存在。
LFormPikachuCosplay = 僅換裝皮卡丘可擁有該形態。
LFormPikachuCosplayInvalid = 換裝皮卡丘不能有普通形態。
LFormPikachuEventInvalid = 神秘禮物配信皮卡丘不能有普通形態。
LFormValid = 合法形態。
LFormVivillon = 合法碧粉蝶花紋。
LFormVivillonEventPre = 退化形態擁有神秘禮物配信碧粉蝶花紋。
LFormVivillonInvalid = 不合法碧粉蝶花紋。
LFormVivillonNonNative = 此碧粉蝶花紋無法於本土生成。
LG1CatchRateChain = 捕獲率不能與該寶可夢進化鏈內種族資料匹配。
LG1CatchRateEvo = 捕獲率與不論遇見方式之種族匹配。應為進化前之捕獲率。
LG1CatchRateItem = 捕獲率與合法二代持有物匹配。
LG1CatchRateMatchPrevious = 捕獲率與進化鏈中某種類匹配。
LG1CatchRateMatchTradeback = 捕獲率與合法第二世代持有物匹配。
LG1CatchRateNone = 捕獲率不能與該寶可夢進化鏈內種族，或第二世代持有物匹配。
LG1CharNick = 來自第一、二世代之昵稱使用了非法字元。
LG1CharOT = 來自第一、二世代之初訓家名字使用了非法字元。
LG1GBEncounter = 不能於VC中特殊遇見該種寶可夢。
LG1MoveExclusive = 初代專屬招式，與無法追蹤之遺傳招式衝突。
LG1MoveLearnSameLevel = 不可共存招式， 為初代中同一等級升級時所選擇招式。
LG1MoveTradeback = 無法追蹤之遺傳招式。與初代專屬招式衝突。
LG1OTEvent = 不正確之初代配信初訓家名。
LG1OTGender = 第一、二世代之初訓家不能為女性。
LG1Stadium = 不正確圓形競技場初訓家。
LG1StadiumInternational = 合法國際版圓形競技場初訓家。
LG1StadiumJapanese = 合法日版圓形競技場初訓家。
LG1TradebackPreEvoMove = 無法追蹤之進化前招式。與第一世代專屬招式不相容。
LG1Type1Fail = 不合法類型A，與種類不匹配。
LG1Type2Fail = 不合法類型B，與種類不匹配。
LG1TypeMatch1 = 合法類型A，與種族匹配。
LG1TypeMatch2 = 合法類型B，與種族匹配。
LG1TypeMatchPorygon = 多邊獸有合法之類型A與B值。
LG1TypePorygonFail = 多邊獸有不合法之類型A或B值，其組合情況不合法。
LG1TypePorygonFail1 = 多邊獸有不合法之類型A值。
LG1TypePorygonFail2 = 多邊獸有不合法之類型B值。
LG2InvalidTilePark = 為自然公園釣魚遇敵。但該水域無法到達。
LG2InvalidTileR14 = 關都14號道路釣魚遇敵。但該水域無法到達。
LG2InvalidTileSafari = 第二世代狩獵區釣魚遇敵。但該區域無法到達。
LG2InvalidTileTreeID = 匹配到水晶版頭錘遇敵。但該樹與初訓家ID不符合。
LG2InvalidTileTreeNotFound = 無法於水晶版找到符合初訓家ID的頭錘遇敵之樹。
LG2OTGender = 除水晶版之外的虛擬主機遊戲中初訓家不能為女性。
LG2TreeID = 匹配到水晶版頭錘遇敵之一棵樹符合初訓家ID。
LG3EReader = 非日版黑暗E-reader寶可夢。未解禁之遇見方式。
LG3OTGender = 來自圓形競技場/暗黑旋風XD之初訓家不能為女性。
LG4InvalidTileR45Surf = 城都45號道路之水面遇見類型，但該水道不可到達。
LG5ID_N = N之初訓家名稱/十六位元表ID(TID16)/十六位元隱ID(SID16)不正確。
LG5IVAll30 = N的寶可夢所有個體值應為30。
LG5OTGenderN = N的寶可夢初訓家性別必須為男性。
LG5PIDShinyGrotto = 於隱藏洞穴捕獲之寶可夢不能為異色。
LG5PIDShinyN = N的寶可夢不能為異色。
LG5SparkleInvalid = 特殊遊戲內寶可夢N的異色標記不應勾選。
LG5SparkleRequired = 特殊遊戲內寶可夢N的異色標記缺失。
LGanbaruStatTooHigh = 一項或多項奮鬥等級超過上限 (10 減 IV 個體值提升奮鬥等級)。
LGenderInvalidNone = 無性別寶可夢不能有性別。
LGeoBadOrder = 地理位置回憶: 間隔/空白存在。
LGeoHardwareInvalid = 地理位置: 國家/地區不在3DS區域內。
LGeoHardwareRange = 不合法主機系統。
LGeoHardwareValid = 地理位置: 國家/地區在3DS區域內。
LGeoMemoryMissing = 地理位置回憶: 回憶應該存在。
LGeoNoCountryHT = 地理位置回憶: 持有人名稱存在但沒有故居。
LGeoNoRegion = 地理位置回憶: 地區沒有國家。
LHyperPerfectAll = 不能對完美個體之寶可夢極限特訓。
LHyperPerfectOne = 不能對完美個體項極限特訓。
LHyperPerfectUnavailable = 無法對任意一項個體值進行極限特訓。
LHyperTooLow_0 = 不能對未滿{0}級之寶可夢極限特訓。
LItemEgg = 蛋不能擁有持有物。
LItemUnreleased = 持有物未解禁。
LIVAllEqual_0 = 所有個體值均為「 {0} 」。
LIVF_COUNT0_31 = 至少有 {0} 項個體值 = 31。
LIVNotCorrect = 個體值與遇見要求不匹配。
LLevelEXPThreshold = 當前經驗值與等級匹配。
LLevelEXPTooHigh = 當前經驗值超過此寶可夢100級時之經驗值上限。
LLevelMetBelow = 當前等級低於遇見等級。
LLevelMetGift = 遇見等級與神秘禮物資料記載等級不匹配。
LLevelMetGiftFail = 遇見等級低於神秘禮物資料記載等級。
LLevelMetSane = 當前等級不低於遇見等級。
LMarkValueOutOfRange_0 = 索引 {0} 上之標記未於允許值内。
LMarkValueShouldBeZero = 不可設置標記。
LMarkValueUnusedBitsPresent = 標記使用之位元超過允許上限。
LMemoryArgBadCatch = {0} 回憶: {0} 沒有捕獲它。
LMemoryArgBadHatch = {0} 回憶: {0} 沒有孵化它。
LMemoryArgBadHT = 回憶: 蛋不能擁有現時持有人之回憶。
LMemoryArgBadID = {0} 回憶: 不能於 {0} 版中獲得回憶。
LMemoryArgBadItem = {0} 回憶: 該寶可夢不能持有此物品。
LMemoryArgBadLocation = {0} 回憶: 不能於 {0} 版中獲得該地點。
LMemoryArgBadMove = {0} 回憶: 當前種類寶可夢無法習得該招式。
LMemoryArgBadOTEgg = {0} 回憶: 連線交換不能為第一回憶。
LMemoryArgBadSpecies = {0} 回憶: 不能於遊戲中捕獲。
LMemoryArgSpecies = {0} 回憶: 當前種類能於遊戲中捕獲。
LMemoryCleared = 回憶: 未完全清理。
LMemoryF_0_Valid = {0} 回憶有效。
LMemoryFeelInvalid = {0} 回憶: 不合法感受。
LMemoryHTFlagInvalid = 未交換: 當前持有者不能為持有人。
LMemoryHTGender = 持有人性別不合法: {0}。
LMemoryHTLanguage = 持有人語言丟失。
LMemoryIndexArgHT = 應該有持有人回憶文本值(某處)。
LMemoryIndexFeel = {0} 回憶: 感受應為序號 {1}。
LMemoryIndexFeelHT09 = 應該有持有人回憶感受值 0-9。
LMemoryIndexID = {0} 回憶: 應為序號 {1}。
LMemoryIndexIntensity = {0} 回憶: 回憶強度應為序號 {1}。
LMemoryIndexIntensityHT1 = 應該有持有人回憶強度值(1st)。
LMemoryIndexIntensityMin = {0} 回憶: 回憶強度應不小於 {1}。
LMemoryIndexLinkHT = 應該有連線交換持有人之回憶。
LMemoryIndexVar = {0} 回憶: 文本值應為序號「 {1} 」。
LMemoryMissingHT = 回憶: 缺失現時持有人之回憶。
LMemoryMissingOT = 回憶: 缺失初訓家之回憶。
LMemorySocialTooHigh_0 = 社交度應 <= {0}。
LMemorySocialZero = 社交度應置「0」。
LMemoryStatAffectionHT0 = 未連線交換: 現時持有人之友好度應置0。
LMemoryStatAffectionOT0 = 初訓家友好度應置「0」。
LMemoryStatEnjoyment = 享受度應該為{0}。
LMemoryStatFriendshipHT0 = 未進行連線交換: 現時持有人之友好度應為置0。
LMemoryStatFriendshipOTBaseEvent = 神秘禮物配信之初訓家友好度與初始友好度不匹配。
LMemoryStatFullness = 飽腹度應該為{0}。
LMetDetailTimeOfDay = 寶可夢之遇見時段不在預期範圍内。
LMoveEggFIncompatible0_1 = {0}之遺傳招式。與遺傳之招式{1}不共存。
LMoveEggIncompatible = 遺傳招式。與神秘禮物配信蛋招式衝突。
LMoveEggIncompatibleEvent = 神秘禮物配信蛋招式。與遺傳招式衝突。
LMoveEggInherited = 遺傳了蛋招式。
LMoveEggInheritedTutor = 遺傳了教學招式。
LMoveEggInvalid = 不應習得之遺傳招式。
LMoveEggInvalidEvent = 神秘禮物蛋不應有遺傳招式。
LMoveEggInvalidEventLevelUp = 神秘禮物蛋不應遺傳升級招式。
LMoveEggInvalidEventLevelUpGift = 神秘禮物蛋不應遺傳升級招式。
LMoveEggInvalidEventTMHM = 神秘禮物蛋不應遺傳「招式學習器/秘傳學習器」招式。
LMoveEggInvalidEventTutor = 神秘禮物蛋不應遺傳教學招式。
LMoveEggLevelUp = 遺傳了升級招式。
LMoveEggMissing = 缺失神秘禮物配信蛋招式。
LMoveEggMoveGift = 神秘禮物蛋不應有遺傳招式。
LMoveEggTMHM = 遺傳了「招式學習器/秘傳學習器」招式。
LMoveEventEggLevelUp = 遺傳升級招式。與神秘禮物蛋招式衝突。
LMoveEvoFCombination_0 = 招式組合與{0}進化型不相容。
LMoveEvoFHigher = 不共存之進化招式。招式 {1} 比其他招式 {0} 習得等級高。
LMoveEvoFLower = 不共存之進化招式。招式 {0} 比其他招式 {1} 習得等級低。
LMoveFDefault_0 = 於第{0}世代之默認招式。
LMoveFExpect_0 = 應該是該招式： {0}。
LMoveFExpectSingle_0 = 應該是該招式： {0}。
LMoveFLevelUp_0 = 於第{0}世代透過升級習得。
LMoveFTMHM_0 = 於第{0}世代透過「招式學習器/秘傳學習器」習得。
LMoveFTutor_0 = 於第{0}世代透過招式教學習得。
LMoveKeldeoMismatch = 凱路迪歐之現時招式與當前形態不匹配。
LMoveNincada = 僅能擁有一個鐵面忍者之招式。
LMoveNincadaEvo = 通過土居忍士進化為鐵面忍者習得。
LMoveNincadaEvoF_0 = 通過土居忍士於第{0}世代進化為鐵面忍者習得。
LMovePPTooHigh_0 = 招式 {0} PP 高於允許值。
LMovePPUpsTooHigh_0 = 招式 {0} PP 高於允許值。
LMoveRelearnDexNav = 非正確忍足招式。
LMoveRelearnEgg = 基本遺傳招式。
LMoveRelearnEggMissing = 缺失基本遺傳招式。
LMoveRelearnFExpect_0 = 應為以下可回憶招式: {0} ({1})。
LMoveRelearnFMiss_0 = 缺失可回憶招式: {0}。
LMoveRelearnInvalid = 非正確回憶招式。
LMoveRelearnNone = 應該沒有回憶招式。
LMoveRelearnUnderground = 非地下大洞窟預期之蛋招式。
LMoveShopAlphaMoveShouldBeMastered = 頭目技能應標記爲精通。
LMoveShopAlphaMoveShouldBeOther = 此頭目遇見方式未能與該頭目招式匹配。
LMoveShopAlphaMoveShouldBeZero = 僅頭目可擁有頭目招式池。
LMoveShopMasterInvalid_0 = 不能設置此招式為精通「 {0} 」: 此招式不允許精通。
LMoveShopMasterNotLearned_0 = 不能設置此招式為精通「 {0} 」: 不可能習得該升級招式。
LMoveShopPurchaseInvalid_0 = 無法從招式商店中習得 「 {0} 」招式。
LMoveSourceDefault = 默認招式。
LMoveSourceDuplicate = 招式重複。
LMoveSourceEgg = 遺傳招式。
LMoveSourceEggEvent = 神秘禮物配信蛋之招式。
LMoveSourceEmpty = 空招式。
LMoveSourceInvalid = 招式不合法。
LMoveSourceInvalidSketch = 招式不合法 (寫生)。
LMoveSourceLevelUp = 透過升級習得。
LMoveSourceRelearn = 可回憶招式。
LMoveSourceShared = 共用之不可回憶招式。
LMoveSourceSharedF = 共用之{0}代不可回憶招式。
LMoveSourceSpecial = 特殊不可回憶招式。
LMoveSourceTMHM = 透過「招式學習器/秘傳學習器」習得。
LMoveSourceTR = 意外之招式記錄標記: {0}。
LMoveSourceTutor = 通過招式教學習得。
LNickFlagEggNo = 蛋名字不能修改。
LNickFlagEggYes = 蛋必須擁有昵稱。
LNickInvalidChar = 無法給寶可夢取中文昵稱。
LNickLengthLong = 昵稱太長。
LNickLengthShort = 昵稱為空。
LNickMatchLanguage = 昵稱與種類名匹配。
LNickMatchLanguageEgg = 蛋名稱與語言匹配。
LNickMatchLanguageEggFail = 蛋名稱與語言不匹配。
LNickMatchLanguageFail = 昵稱與種類名不匹配。
LNickMatchLanguageFlag = 昵稱被標記，與種類名匹配。
LNickMatchNoOthers = 昵稱不與另一種類名匹配。
LNickMatchNoOthersFail = 昵稱與另一寶可夢種類名匹配 (+language)。
LOT_IDEqual = 十六位元表ID(TID16)及十六位元隱ID(SID16)相等。
LOT_IDInvalid = 表ID及隱ID組合不可能於游戲中獲得。
LOT_IDs0 = 十六位元表ID(TID16)與十六位元隱ID(SID16)為 0。
LOT_SID0 = 十六位元隱ID(SID16)為 0。
LOT_SID0Invalid = 十六位元隱ID(SID16)應為 0。
LOT_TID0 = 十六位元表ID(TID16)為 0。
LOTLanguage = 語言ID應為 {0}, 而不是 {1}。
LOTLong = 初訓家名字過長。
LOTShort = 初訓家名字過短。
LOTSuspicious = 可疑之初訓家信息。
LPIDEncryptWurmple = 刺尾蟲之進化形態與加密常量不匹配。
LPIDEncryptZero = 未設置加密常量。
LPIDEqualsEC = 加密常量與 PID 相同。
LPIDGenderMatch = 性別與 PID 匹配。
LPIDGenderMismatch = 性別與 PID 記載值不匹配。
LPIDNatureMatch = 性格與 PID 記載值匹配。
LPIDNatureMismatch = 性格與 PID 記載值不匹配。
LPIDTypeMismatch = 遇見類型與 PID 記載值不匹配。
LPIDZero = 未設置 PID 。
LPokerusDaysTooHigh_0 = 寶可病毒剩餘天數過長; 應 <= {0}。
LPokerusStrainUnobtainable_0 = 寶可病毒種類 {0} 不可獲得。
LRibbonAllValid = 所有獎章合法。
LRibbonEgg = 蛋不能獲取獎章。
LRibbonFInvalid_0 = 不合法獎章: 
LRibbonFMissing_0 = 缺失獎章: 
LRibbonMarkingAffixedF_0 = 無效之獎章/證章: {0}。
LRibbonMarkingFInvalid_0 = 無效證章: {0}。
LStatAlphaInvalid = 頭目標識不合法。
LStatBattleVersionInvalid = 對戰版本不在期望範圍內。
LStatDynamaxInvalid = 極巨化等級不在預期範圍內。
LStatGigantamaxInvalid = 超極巨標識不匹配。
LStatGigantamaxValid = 超極巨標識已被極巨湯修改。
LStatIncorrectCP = 計算之 CP 值與存儲值不匹配。
LStatIncorrectHeight = 計算之高度與存儲值不匹配。
LStatIncorrectHeightCopy = 複製之高度與原值不匹配。
LStatIncorrectHeightValue = 高度與期望值不匹配。
LStatIncorrectWeight = 計算之重量與存儲值不匹配。
LStatIncorrectWeightValue = 體重與期望值不匹配。
LStatInvalidHeightWeight = 此身高或體重於統計學意義上不可獲得。
LStatNatureInvalid = 薄荷修正之性格表現不在期望範圍內。
LStatNobleInvalid = 王標識不合法。
LSuperComplete = 超級訓練完成標識不匹配。
LSuperDistro = 神秘禮物配信超級訓練任務未發佈。
LSuperEgg = 不能對蛋進行超級訓練。
LSuperNoComplete = 當前出身游戲不能有超級訓練完成之標記。
LSuperNoUnlocked = 當前出身游戲不能有超級訓練解鎖之標記。
LSuperUnavailable = 所達遊戲版本不能進行超級訓練。
LSuperUnused = 未使用之超級訓練旗標被標識。
LTeraTypeIncorrect = 太晶屬性與期望值不匹配。
LTeraTypeMismatch = 太晶屬性無法與寶可夢本身任一屬性相匹配。
LTradeNotAvailable = 該遇見方式寶可夢不可被交換至現時持有之訓練家手上。
LTransferBad = 該寶可夢不正確地由前代游戲中傳送而來。
LTransferCurrentHandlerInvalid = 不合法之現時持有人資訊，儲存資料訓練家信息應是其他值。
LTransferEgg = 不能跨世代傳送蛋。
LTransferEggLocationTransporter = 不合法之遇見地點, 應該是虛擬傳送。
LTransferEggMetLevel = 對於寶可傳送不合法之遇見等級。
LTransferFlagIllegal = 游戲中被標記爲非法 (可濫用之Bug)。
LTransferHTFlagRequired = 透過寶可傳送帶過來之前代游戲寶可夢，現時持有人不能為前代之初訓家。
LTransferHTMismatchGender = Handling trainer does not match the expected trainer gender.
LTransferHTMismatchLanguage = 現時持有人與期望語言不匹配。
LTransferHTMismatchName = 現時持有人與期望名字不匹配。
LTransferMet = 不合法遇見地點，應該為寶可傳送或王冠。
LTransferMetLocation = 傳送遇見地點不合法。
LTransferMove = 不相容之虛擬傳送招式。
LTransferMoveG4HM = 需要清除招式「濃霧」與「潮旋」。兩者於傳到5代以前必須被移除。
LTransferMoveHM = 第{0}世代秘傳學習器（秘傳學習器招式）。應於傳至第{1}世代前被移除。
LTransferNature = 對於寶可傳送不合法之性格。
LTransferNotPossible = 無法將現時寶可夢檔格式轉換爲源寶可夢檔格式。
LTransferObedienceLevel = 可指揮等級不合法。
LTransferOriginFInvalid0_1 = 「 {0} 」來源之寶可夢，不能含有於「 ({1}) 」中之遊戲記錄。
LTransferPIDECBitFlip = PID應與加密常量相同[首位須反轉]！
LTransferPIDECEquals = PID應與加密常量相同！
LTransferPIDECXor = 加密常量與異色 PID 之 XOR 值匹配。
LTransferTrackerMissing = Pokémon HOME 傳輸跟蹤碼資訊丟失。
LTransferTrackerShouldBeZero = Pokémon HOME 傳輸跟蹤碼資訊應置 0。
LTrashBytesExpected = Expected Trash Bytes.
LTrashBytesExpected_0 = Expected Trash Bytes: {0}
LTrashBytesMismatchInitial = Expected initial trash bytes to match the encounter.
LTrashBytesMissingTerminator = Final terminator missing.
LTrashBytesShouldBeEmpty = Trash Bytes should be cleared.
LTrashBytesUnexpected = Unexpected Trash Bytes.
